11111111111
1C0111CME11
110M1M0MMC1
1M0P00C1011
11111111111