11111111111111111
11PCC10MC00C0M0C1
1M0011M01M0111101
11MC00C1110CM0M01
1C001M00C0000C0E1
11111111111111111
