11111111111111111
1P10C0M111C00M0C1
10C0MC0C000M01001
10M100101111C0CM1
1C01MC10CM01M00E1
1M01111011110C0M1
1C000M1C100M010C1
10M0C01M1111C0M11
11111111111111111
