1111111111111111
10C010C00F010001
1000100E00010001
1000111110000001
1P00000000001111
1000000C00000001
1001111111000001
100100C0001000C1
1111111111111111